name Very Small Labyrinth of Dooom
win 1
###################
#.................#
#..E...G........E.#
#.........G.......#
#..E...G......E...#
#..........G..G...#
#.G...............#
#..E..............#
###################